Folder 对象用来返回有关指定文件夹的信息。
Folder 对象
Folder 对象用于返回有关指定文件夹的信息。
如需操作 Folder 对象，我们需要通过 FileSystemObject 对象来创建 Folder 对象的实例。首先，创建一个 FileSystemObject 对象，然后通过 FileSystemObject 对象的 GetFolder 方法来例示这个 Folder 对象。
下面的代码使用 FileSystemObject 对象的 GetFolder 方法来例示这个 Folder 对象，并使用 DateCreated 属性来返回指定文件的创建日期：
<%
Dim fs,fo
Set fs=Server.CreateObject("Scripting.FileSystemObject")
Set fo=fs.GetFolder("c:\test")
Response.Write("Folder created: " & fo.DateCreated)
set fo=nothing
set fs=nothing
%>
输出：
Folder created: 10/22/2001 10:01:19 AM
Folder 对象的集合、属性以及方法
集合
集合 	描述
Files 	返回指定文件夹中所有文件夹的集合。
SubFolders 	返回指定文件夹中所有子文件夹的集合。
属性
属性 	描述
Attributes 	设置或返回指定文件夹的属性。
DateCreated 	返回指定文件夹被创建的日期和时间。
DateLastAccessed 	返回指定文件夹最后被访问的日期和时间。
DateLastModified 	返回指定文件夹最后被修改的日期和时间。
Drive 	返回指定文件夹所在的驱动器的驱动器字母。
IsRootFolder 	假如文件夹是根文件夹，则返回 ture，否则返回 false。
Name 	设置或返回指定文件夹的名称。
ParentFolder 	返回指定文件夹的父文件夹。
Path 	返回指定文件的路径。
ShortName 	返回指定文件夹的短名称。（8.3 命名约定）
ShortPath 	返回指定文件夹的短路径。（8.3 命名约定）
Size 	返回指定文件夹的大小。
Type 	返回指定文件夹的类型。
方法
方法 	描述
Copy 	把指定的文件夹从一个位置拷贝到另一个位置。
Delete 	删除指定文件夹。
Move 	把指定的文件夹从一个位置移动到另一个位置。
CreateTextFile 	在指定的文件夹创建一个新的文本文件，并返回一个 TextStream 对象以访问这个文件。